XXXXXXXXXXXXXX
X            X
X XXX X   XX X
X  X  XX XXX X
X XX      X  X
X    X  X    X
X X XXX X XXXX
X X  X  X    X
X XX   XXX  XX
X    X       X
XXXXXXXXXXXXXX
